##################################################
#            *                                   #
#                                                #
#                                                #
#                                                #
#                                                #
#                                                #
#                                                #
#         #####                                  #
#                                                #
#                                                #
#                                                #
#                                                #
#                                                #
#          0                                     #
#                                                #
#                                                #
#                                                #
#                                                #
#                                                #
#                                                #
#                                                #
#                                                #
#                                                #
#                                                #
#                                                #
#                                                #
#                                                #
#                                                #
##################################################
