 ################################################
 #            *                                 #
 #                                              #
 #                                              #
 #                                              #
 #                                              #
 #                                              #
 #                                              #
 ################                ################
 #                                              #
 #                                              #
 #                                              #
 #                                              #
 #                                              #
 #          0                                   #
 #                                              #
 #                                              #
 #                                              #
 #                                              #
 #                                              #
 #                                              #
 #                                              #
 #                                              #
 #                                              #
 #                                              #
 #                                              #
 #                                              #
 ################################################
